==controls==

left click drag on empty space - new blocks/notes
left click drag on selected pattern - move or resize blocks/notes
left click - select block/note
shift left click - select more blocks/notes
shift left click drag - box select blocks/notes
right click - delete blocks/notes
middle click - paste selected blocks/notes

control c - copy selected blocks / notes
control v - paste copied blocks / notes
control z - undo
control y - redo
control a - select none / select all
delete - delete selected blocks / notes

right arrow - zoom in
left arrow - zoom out

control s - save
control o - open
control w - save as
control n - erase everything

ctrl+backspace - reset play head
ctrl+return - toggle recording
ctrl+space - toggle play


You can play notes with the keyboard.
This is the layout for qwerty.

 # #   # # #   # #
C D E F G A B C D E

 2 3   5 6 7   9 0   = \
q w e r t y u i o p [ ] 

 s d   g h j   k l
z x c v b n m , . /

space - sustain pedal
shift+[ - octave down one
shift+] - octave up one


==song view special controls==
control left click - mute/unmute pattern
double left click - edit pattern


==event edit special controls==
left click drag - change event values with line
shift left click drag - box select
ctrl left click drag - insert new event
right click drag - delete events in range
right click - clear selection
delete key - delete all selected events
